111111111111111
1P0001110000001
10000C000000001
10000000C0000E1
111111111111111
